++++++++++++++++++++++++++
+a                       +
+ A                      +
+                        +
+                        +
+                        +
+                        +
+                        +
+                        +
+                        +
+                        +
+                        +
+                        +
+                        +
+                        +
+                        +
+                        +
+                       0+
++++++++++++++++++++++++++