+++++++++++++++++++
+                 +
+                 +
+                 +
+                 +
+                 +
+                 +
+                 +
+                 +
+              a  +
+               A +
+                 +
+                 +
+                0+
+++++++++++++++++++